Michael Jackson - Thriller
AC/DC - Back in Black
Pink Floyd - The Dark Side of the Moon
The Beatles - Abbey Road
Fleetwood Mac - Rumours
Nirvana - Nevermind
Prince - Purple Rain
Bob Dylan - Blood on the Tracks
Lauryn Hill - The Miseducation of Lauryn Hill
The Beatles - Revolver
Marvin Gaye - What's Going On
The Beach Boys - Pet Sounds
Joni Mitchell - Blue
Stevie Wonder - Songs in the Key of Life
Aretha Franklin - I Never Loved a Man the Way I Love You
The Rolling Stones - Exile on Main St.
David Bowie - The Rise and Fall of Ziggy Stardust and the Spiders from Mars
The Clash - London Calling
U2 - The Joshua Tree
Bruce Springsteen - Born to Run
Radiohead - OK Computer
Kendrick Lamar - To Pimp a Butterfly
Beyonc√© - Lemonade
Adele - 21
Taylor Swift - 1989
OutKast - Speakerboxxx/The Love Below
Jay-Z - The Blueprint
Eminem - The Marshall Mathers LP
Dr. Dre - The Chronic
2Pac - All Eyez on Me
Kanye West - My Beautiful Dark Twisted Fantasy
The Notorious B.I.G. - Ready to Die
Metallica - Master of Puppets
Guns N' Roses - Appetite for Destruction
Led Zeppelin - Led Zeppelin IV
Queen - A Night at the Opera
The Who - Who's Next
The Doors - The Doors
The Velvet Underground - The Velvet Underground & Nico
The Smiths - The Queen Is Dead
Joy Division - Unknown Pleasures
Pixies - Doolittle
R.E.M. - Automatic for the People
Oasis - (What's the Story) Morning Glory?
Blur - Parklife
Coldplay - A Rush of Blood to the Head
Arcade Fire - Funeral
The Strokes - Is This It
Amy Winehouse - Back to Black
Lana Del Rey - Born to Die
